#Example: Most of Europe north of med.
    mild_winter = {
# Ireland
    3 5 7
# Ireland
    2 4 6 8 9 10 11
# British Isles
    28 30 49
# England & Wales
    12 13 14 15 16 17 18 19 20 21 22 23 24 25 26 27 47 48 50 51 52 53 54 55 56 57 58 59 60 61 62 63 64 65 66 67 68
# Netherlands
    69 71 72 73 74 90 92 93 94 95 106
# France
    70 86 87 88 89 91 107 108 109 111 112 129 131 134 135 136
# Brittany
    83 84 85
# Italy
    154 184 185 186
# Iberia

# Mongol Empire
    338 339 340 345 507 508 509 651 652 680 703
# Albania
    284 285 318 319 320 283
# Hungary
    215 220 221 222 223 224 225 226 227 228 229 230 231 232 233 237 238 239
# Turkey
    377 398 399 402 403 432 433 445 446 447 455 448 449 456
# Tarim basin + gobi

# Other
    370 364 365 369 372 373 376 375 566 366 367 368 378 400 363 381 362 382
    }

#Example: Inland Europe & Scandinavia
    normal_winter = {
# Iceland

# British Isles
    29 31
# Lower Scandinavia
    141 143 1 140 139 138
# Scotland
    32 33 34 35 36 37 38 39 40 41 42 43 44 45 46
# Denmark
    142 144 145 146
# East Frisia
    75 76 77 78 79 80 81 82 96 97 98 99 147 148 149 150 151
# France
    132 133 130
# Germany
    101 102 103 104 105 110 174 175 176 177 179
# Poland/Lithuania
    178 180 243 244 245 246 247 248
    249 250 251 252 253 254 255 256 257 258 259 260 261 262 263 264 267 268 269 271 272
# Pyrenees
    114 113
# Mongolia

# Other
    100 152 153 183 234 235 236 240 241 242 265 266 280 286 315 324 326 335 337 704 506 505 654
    323 325 371 322 321 318 316 317 281 282
    }

#Example: Russia & Lappland
    severe_winter = {
# Scandinavia

# Russia
    274 275 276 277 278 279 287 288 289 290 291 292 293 294 295 296 297 298
    299 300 301 302 303 304 305 306 307 308 309 310 311 312 313 314 327 328 329 330 331 332 333 334 336 510 702 511 273 270
# Pyrenees

# Alps
    137
# Mongolia

    }
